111111111111111
 111111111111111
110000000000011
11000S000000011
110000000000011
110000000000 0 11
110000000000011
110000000000011
111111111111111
111111111111111