  1        1
 1111   11111111
100001 100010001
100001100S010001
1101111000010001
 101001000000001
 101001000000001
 101111000010001
 100000000010001
 111011111111001
100101    100001
100101   1000001
100001  10000001
111111 10000001
       1111111