111111111111111
111111111111111
1100000000011
110000000000011
11000000000000011
1100000S0000000011
1100000000000000011
110000000000000011
11000000000000011
110000000000011
111111111111111
111111111111111