R 680 480

NO path to N
S pathSprite
EA pathE
WE pathW
SO pathS
F pathFloor
C pathTop

1111111111 
1000100011 
1010101011 
1010101011 
1010101011 
1010101011 
1010101011 
1010101011 
1N10001001 
1111111111