
NO path to N
S pathSprite
EA pathE
WE pathW
SO pathS
F pathFloor
C pathTop

111111111111
111111111111
110000000011
110000S00011
110000000011
110000000011
111111111111
111111111111