R 680 480


NO path to N
S pathSprite
EA pathE
WE pathW

SO pathS
F pathFloor
C pathTop

 1111111111
100000000011
 1000000000011
100000000000001
 100000E000000011
10001000000000001

1000010000000001
 100001000000111
1000000000001


1111111111111